                                                                 
    ____________________________________________________________________________
    |      #######################################           #### $ ####        |
    |            ############################                 ###   ###         |
    |        ________             ________                     ##   ##          |
    |       /       /\           /       /\                                     |
    |      /_______/  \         /_______/  \            (()(()((())((()((()     |
    |      |0 ___ 0|  |         |0 ___ 0|  |           ())(())))())))()))(()    |
    |      |__| |__|__|         |__| |__|__|            || ||| ||||| ||||||     |
    |                                                                           |
    |                                                                           |
    |                                                                   ####### |    
    |               #######                                        ###########  |                                                     
    |              ###########                                  ##############  |   
    |            ##############                           ##################    |                        
    |          ##################                           ################    |
    |           ################                             ###############    |                 
    |            ###############                             ########           |
    |                #####                                                      |
    |                                                                           |
    |                                           (()(()((())((()((()             |
    |                       ________           ())(())))())))()))(()            |
    |                      /       /\           || ||| ||||| ||||||             |                                                                                
    |                     /_______/  \                                          |
    |                     |0 ___ 0|  |             ######################       |
    |                     |__| |__|__|                 ##################       |                                 
    |                                                    ###############        |
    |                                                         ########          |
    |                                                                           |
    |___________________________________________________________________________|