

 _____________________________________________________________________________
 | #######                                                                    |
 | #######                                                                    |
 | #####____                                                                  |
 | ####|    |                                                                 |
 | ####|    |                                                                 |
 | ####|____|######                                                           |
 |              ########                                                      |
 |                   #########                                                |
 |############################                                                |
 |____________________________________________________________________________|
