

 ______________________________
 | #######                    $|
 | #######                     |
 | #####____                   |
 | ####|    |                  |
 | ####|    |                  |
 | ####|____|######            |
 |              ########       |
 |                   ######### |
 |############################ |
 |_____________________________|
